111111111111111111111111
1P0100010000100C001000E1
100000C0000010000010C001
1001000100000C001110C001
100100010C00111000000001
10010001000000100C000001
10000001000C001000000CE1
111111111111111111111111
