1111111111111
10010000000C1
10111ECC00011
1010001101111
1100000001111
10CCC10P000C1
1111111111111
